{
  "name": "Glove80 Layout",
  "layout": [
    ["X", "X", "X", "X", "X", "-", "-", "-", "-", "-", "-", "-", "-", "X", "X", "X", "X", "X"],
    ["X", "X", "X", "X", "X", "X", "-", "-", "-", "-", "-", "-", "X", "X", "X", "X", "X", "X"],
    ["X", "X", "X", "X", "X", "X", "-", "-", "-", "-", "-", "-", "X", "X", "X", "X", "X", "X"],
    ["X", "X", "X", "X", "X", "X", "-", "-", "-", "-", "-", "-", "X", "X", "X", "X", "X", "X"],
    ["X", "X", "X", "X", "X", "X", "X", "X", "X", "X", "X", "X", "X", "X", "X", "X", "X", "X"],
    ["X", "X", "X", "X", "X", "-", "X", "X", "X", "X", "X", "X", "-", "X", "X", "X", "X", "X"]
  ]
}
